11111111
1C101P01
11100001
1E000001
11111111