111111
100001
100C01
100001
100C01
1E0001
100C01
100001
100P01
100001
111111