111111111111111111111111111111111111111111111111111
100000000000000000000000000000000000000000000000001
100000000P00000000000000000000000000000C00000000001
100000000000000000000000000000000000000E00000000001
100000000001111111111110000000000000000000000000001
10000000000110C000C111100000000000000000C0000000001
1000000000011C0000011000000000000000000000000000001
100000000000111001110000000000000000000000000000001
10000000000001001000000C000000000000000000000000001
10000000000C001010000000000000000011111111111000001
100000000000000000000000000000000010000000000000001
1000000000000000000000000000000000100000000000C0001
100000000000000000000000000000000010000000000000001
111111111111111111111111111111111111111111111111111