
111111111111111111111111111
11P001101C000000010000011E1
110101101111111101C11101101
110100000000000001100000001
11C111111111111100001111111
111111111111111111111111111