11111111111111111111
100P00000000000C0001
10000000000000000001
10000000000000000001
10000000000000000001
10000000000000000E01
11111111111111111111