11111111111111111111
100P000000000000C001
100000000000000E0001
10000000000C0000E001
11111111111111111111