
11111111111111111111
1000P00000000000C001
10000000000000000000
10000000000C0000E001
11111111111111111111