11111111111111111111
100P000000000F000001
1000000000C000000001
10000C00000000000E01
11111111111111111111